------------
------------
---333333---
--3------3--
-3-222222-3-
3----------3
3-11111111-3
3----------3
-3-222222-3-
--3------3--
---333333---
------------
------------
------------
------------
------------
------------
------------