------------
------------
------------
--11111111--
-1--------1-
1-2------2-1
1--3----3--1
1---4--4---1
1----55----1
1----------1
111111111111
------------
------------
------------
------------
------------
------------
------------