------------
111111111111
1----------1
1--222222--1
1----------1
1--333333--1
1----------1
1--444444--1
1----------1
1----------1
111111111111
------------
------------
------------
------------
------------
------------
------------