------------
------------
---555555---
--5------5--
-5-444444-5-
5----------5
5-33333333-5
5----------5
-5-222222-5-
--5------5--
---111111---
------------
------------
------------
------------
------------
------------
------------