------------
222222222222
2----------2
2---3333---2
2----------2
2-333--333-2
2-343--343-2
2-333--333-2
2----------2
2----------2
222222222222
------------
------------
------------
------------
------------
------------
------------
